🌴🌴🌴🌴🌴🌴🌴🌴🌴🌴🌴🌴🌴🌴🌴🌴🌴🌴🌴🌴🌴🌴🌴🌴🌴🌴🌴🌴🌴🌴🌴🌴🌴🌴🌴🌴🌴🌴🌴🌴🌴🌴🌴🌴🌴🌴🌴🌴🌴🌴🌴🌴🌴
🌴...................................................🌴
🌴...................................................🌴
🌴...................................................🌴
🌴.......🌴🌴🌴🌴🌴🌴🌴🌴🌴🌴🌴🌴................................🌴
🌴🌴..........🌴🌴🌴..🌴🌴🌴🌴..🌴🌴🌴🌴🌴🌴.......................🌴
🌴.............🌴🌴🌴🌴🌴🌴🌴🌴🌴.............................🌴
🌴...................................................🌴
🌴...................................................🌴
🌴...................................................🌴
🌴...................................................🌴
🌴...................................................🌴
🌴...................................................🌴
🌴...................................................🌴
🌴...................................................🌴
🌴...................................................🌴
🌴...................................................🌴
🌴...................................................🌴
🌴..$................................................🌴
🌴...................................................🌴
🌴...................................................D
🌴🌴🌴🌴🌴🌴🌴🌴🌴🌴🌴🌴🌴🌴🌴🌴🌴🌴🌴🌴🌴🌴🌴🌴🌴🌴🌴🌴🌴🌴🌴🌴🌴🌴🌴🌴🌴🌴🌴🌴🌴🌴🌴🌴🌴🌴🌴🌴🌴🌴🌴🌴🌴
